......................
......................
...111................
.............111......
......................
..11....11.........11.
..............11......
.............1........
..11..................
.......1111...........
.......1.....1....11..
.....11...1111...11...
...111...........1..1.
.................1.1..
......1.....1....1....
11111111..111111111111
1111111111111111111111