........................
........................
...111..................
.............111........
........................
........11.........11...
..............11........
.............1..........
..11....................
.......1111.............
.......1.....1....11....
.....11...1111...11.....
...111...........1..1...
.................1.1....
......1.....1....1......
11111111..11111111111111
111111111111111111111111
60 600